1111111111111111111111111111111111
1E10000000000000000000000000000001
1000101001000001010010000000101011
1010010010101010001001000000010101
1010010010101010001001000000010101
1010010010101010001001000000001011
101C010010101010001001000000011101
1P00000000000000000000000000000011
1111111111111111111111111111111111