1111111111111111111111111111111111
1E00000000000000000000000000000001
1100101001000001010010000000101011
1010010010101010001001000000010101
101C010010101010001001000000010101
1010010010101010001001000000010101
101C010010101010001001000000010101
1P00C00000000000000000000000000011
1111111111111111111111111111111111